¿Que causa el apego inseguro?	Intermitencia o inconstancia de atención por parte de los padres y por cuidados poco afectuosos.	DesarrolloEmocional	A&B
¿Qué es el apego acorde Ainsworth y Bowlby?	Es un vínculo emocional duradero que relaciona a dos personas a través del tiempo y del espacio	DesarrolloEmocional	A&B
¿Tipo de apego en la que el niño no puede contar con sus cuidadores para satisfacer sus necesidades? (sabe que será rechazado)	Inseguro evitativo	DesarrolloEmocional	A&B
¿Acorde a Konrad Lorenz, a que edad un bebe debe de establecer un apego para que se desarrolle de forma normal?	Antes de los 8 meses	DesarrolloEmocional	A&B
¿Tipo de apego patológico?	Inseguro desorganizado	DesarrolloEmocional	A&B
¿En cuál etapa un niño comprende que la ausencia de su madre no es definitiva?	Etapa de las relaciones reciprocas	DesarrolloEmocional	A&B
¿Qué es el andamiaje?	Estructuración progresiva de la interacción entre progenitor e hijos por parte de los padres	DesarrolloEmocional	A&B
¿Tipo de apego post Ainsworth	Inseguro desorganizado	DesarrolloEmocional	A&B
¿En cuál etapa del apego se genera ansiedad al separarse de humanos?	En la etapa de formación del apego	DesarrolloEmocional	A&B
¿En cuál etapa del apego un bebe puede aceptar a cualquier humano que lo conforte?	Etapa de preapego (0-6)	DesarrolloEmocional	A&B
¿Cuántas fases del apego hay?	4: preapego, formación del apego, apego y etapa de las relaciones reciprocas.	DesarrolloEmocional	A&B
¿Cuál etapa del apego se da entre los 8 y 24 meses?	Etapa del apego	DesarrolloEmocional	A&B
¿En cuál etapa del apego los reflejos son muy importantes?	Etapa de preapego	DesarrolloEmocional	A&B
¿Quién propuso que los bebes nacen con conductas programadas para mantener cerca a sus padres y para sensibilizarlos?	Bowlby	DesarrolloEmocional	A&B
¿Cuáles son los mecanismos de apego acorde a Bowlby?	Señales (llanto, sonrisa, vocalizaciones), orientación de la mirada, movimientos hacia otras personas (como seguirlos o acercárseles), intentos de contacto físico	DesarrolloEmocional	A&B
¿Entre qué edad se da la etapa del preapego?	0-6 meses	DesarrolloEmocional	A&B
¿Cuál tipo de apego tiene impactos en el desarrollo psicoemocional y cognitivo de una persona?	Inseguro desorganizado	DesarrolloEmocional	A&B
¿Características del apego seguro?	El niño explora con confianza, sabe que su cuidador responderá si lo necesita, el cuidador es sensible a las necesidades de niño. El niño siente que sus emociones son validadas	DesarrolloEmocional	A&B
¿Quién fue el primero en describir el concepto del apego?	Konrad Lorenz	DesarrolloEmocional	A&B
¿Entre que edades se da la etapa del apego?	8-24 meses	DesarrolloEmocional	A&B
¿En cuál etapa del desarrollo del apego se da preferencia únicamente a la madre y el rechazo a otras personas?	Etapa del apego	DesarrolloEmocional	A&B
¿Tipo de apego en la que él bebe desconoce si sus cuidadores estarán disponibles cuando lo requiera?	Apego inseguro ansioso	DesarrolloEmocional	A&B
¿En qué años surgió la teoría del apego de Bowlby?	60's	DesarrolloEmocional	A&B
¿Cuáles son las dos reacciones que puede tener un niño cuando presenta apego inseguro?	Evitativo a la madre cuando regresa/ ambivalente: busca y rechaza el afecto que le pueden dar	DesarrolloEmocional	A&B
¿Cuál Área está en el lóbulos frontal y cuál es su Función?	Área de Broca para la producción del lenguaje.	DesarrolloEmocional	Corteza
¿En cuál lóbulos cerebral se da el procesamiento espacial? (equilibrio, orientación, percepción)	Lóbulos Parietal	DesarrolloEmocional	Corteza
¿Cuál lóbulos procesa información somatosensorial?	Parietal	DesarrolloEmocional	Corteza
¿Cuáles son los lóbulos del cerebro?	Frontal, parietal, occipital y temporal	DesarrolloEmocional	Corteza
¿Cuáles estructuras componen al SNC?	Cerebro y Medula	DesarrolloEmocional	Corteza
¿En qué lóbulos cerebral ocurre la toma de decisiones?	Lóbulos frontal	DesarrolloEmocional	Corteza
¿En cuál hemisferio se procesa la mayoría del lenguaje?	Izquierdo	DesarrolloEmocional	Corteza
¿En qué lóbulos ocurre principalmente la asociación de conceptos?	Frontal	DesarrolloEmocional	Corteza
¿En cuál lóbulos del cerebro se procesan las Funciones ejecutivas superiores?	Lóbulos frontal	DesarrolloEmocional	Corteza
¿Con que se relaciona al lóbulos occipital?	Procesamiento visual, percepción de profundidad, reconocimiento de rostros y colores	DesarrolloEmocional	Corteza
¿En cuál lóbulos cerebral están las neuronas espejo?	Lóbulos frontal	DesarrolloEmocional	Corteza
¿En cuál lóbulos se encuentra el yo?	En el lóbulos frontal	DesarrolloEmocional	Corteza
¿En cuál lóbulos está el hipocampo?	En el lóbulos temporal	DesarrolloEmocional	Corteza
¿Función de las neuronas espejo?	Empatía (nos vemos reflejados en otras personas)	DesarrolloEmocional	Corteza
¿Con que se asocia el lóbulos temporal?	Con la audición y su procesamiento	DesarrolloEmocional	Corteza
¿Lóbulos que procesa Funciones motoras	Frontal	DesarrolloEmocional	Corteza
¿Cuál lóbulos procesa y reconoce rostros y colores?	Lóbulos Occipital	DesarrolloEmocional	Corteza
¿Cuál lóbulos procesa y registra información de sensaciones somáticas?	Lóbulos Parietal	DesarrolloEmocional	Corteza
¿Qué es la discriminación de estímulos?	Capacidad para responder diferente a estímulos similares	DesarrolloEmocional	Condicionamiento
¿Tipo de estímulo que fue apareado con uno incondicionado para provocar una respuesta aprendida?	Estimulo condicionado	DesarrolloEmocional	Condicionamiento
¿Tipo de condicionamiento basado en las consecuencias de una acción?	Condicionamiento operante	DesarrolloEmocional	Condicionamiento
¿Estimulo agradable retirado?	Castigo negativo	DesarrolloEmocional	Condicionamiento
¿Reforzamiento negativo?	Estimulo aversivo retirado	DesarrolloEmocional	Condicionamiento
¿Cuál tipo de reforzador que se aprende por medio de la asociación con reforzadores primarios?	Secundario	DesarrolloEmocional	Condicionamiento
¿Tipo de condicionamiento que no suele requerir pensamiento	Asociativo	DesarrolloEmocional	Condicionamiento
¿Acorde a Bandura, como se aprende la conducta?	Primero socialmente y luego se internaliza	DesarrolloEmocional	Condicionamiento
¿Como se obtienen conductas y actitudes según Bandura?	Por medio de la observación del ambiente	DesarrolloEmocional	Condicionamiento
¿Cuál es el tipo de reforzador primario?	Reforzador no aprendido que satisface necesidades fisiológicas	DesarrolloEmocional	Condicionamiento
¿Castigo positivo?	Presentación de estímulos aversivo.	DesarrolloEmocional	Condicionamiento
¿Qué dice Bandura sobre el aprendizaje?	Que se da por imitación de modelos por acción de neuronas espejo	DesarrolloEmocional	Condicionamiento
¿Estimulo agradable presentado?	Reforzamiento positivo	DesarrolloEmocional	Condicionamiento
¿Si los reforzadores no son necesarios, según Bandura como aprendemos?	Aprendemos socialmente por las consecuencias de nuestras acciones	DesarrolloEmocional	Condicionamiento
¿En cuál etapa del aprendizaje de Bandura la conducta se refuerza por repetición?	Segunda etapa	DesarrolloEmocional	Condicionamiento
¿Tipo de condicionamiento donde un individuo hace una asociación entre estímulos y comportamientos?	Asociativo	DesarrolloEmocional	Condicionamiento
¿Qué es una respuesta condicionada?	Reacción aprendida por medio del apareamiento de un estímulo originalmente neutro con uno incondicionado.	DesarrolloEmocional	Condicionamiento
¿Que son las respuestas incondicionadas?	Respuestas a estímulos que no requieren experiencias previas	DesarrolloEmocional	Condicionamiento
¿Estimulo que no está asociado a experiencias previas ni provoca respuestas?	Estimulo neutro	DesarrolloEmocional	Condicionamiento
¿Tipo de condicionamiento relacionado con el cambio en la conducta	Condicionamiento operante	DesarrolloEmocional	Condicionamiento
¿Teoría del condicionamiento que afirma que los reforzadores no son necesarios?	Bandura	DesarrolloEmocional	Condicionamiento
¿Como Funciona el condicionamiento clásico?	Por medio de aparear dos o más estímulos para que se asocien en el cerebro de un individuo	DesarrolloEmocional	Condicionamiento
¿Cuáles son los tres componentes en la teoría de Bandura?	Reproducción, motivación y retención	DesarrolloEmocional	Condicionamiento
¿Que demuestra el condicionamiento clásico?	Que la experiencia puede modificar la conducta	DesarrolloEmocional	Condicionamiento
¿En cuál etapa del aprendizaje de Bandura el sujeto se puede identificar con su modelo?	Tercera etapa	DesarrolloEmocional	Condicionamiento
¿Primera etapa del aprendizaje según Bandura?	imitación de modelos similares	DesarrolloEmocional	Condicionamiento
¿Qué es el condicionamiento de orden superior?	Cuando un estímulo previamente condicionado se usa para reforzar aprendizaje complementario	DesarrolloEmocional	Condicionamiento
¿Tipo de estímulo que provoca respuestas sin experiencias previas?	Incondicionado	DesarrolloEmocional	Condicionamiento
¿Qué es la generalización de estímulos?	Capacidad de responder igual ante estímulos	DesarrolloEmocional	Condicionamiento
¿Tipo de condicionamiento que es que si requiere procesos mentales para que se dé?	Condicionamiento cognitivo	DesarrolloEmocional	Condicionamiento
¿Que debe de resquebrajarse para superar el dilema entre la intimidad y el aislamiento?	El egocentrismo debe de resquebrajarse para darle paso al amor	DesarrolloEmocional	Erickson
¿Cuántas etapas hay en el desarrollo psicosocial de Erickson	8 etapas	DesarrolloEmocional	Erickson
¿A qué edad se da la etapa de la confianza?	Del nacimiento al año	DesarrolloEmocional	Erickson
¿Que se adquiere al superar la integridad?	Sabiduría	DesarrolloEmocional	Erickson
¿A qué se enfrenta la generatividad?	Al estancamiento	DesarrolloEmocional	Erickson
¿A qué edad surge la laboriosidad?	06-dic	DesarrolloEmocional	Erickson
¿Qué etapa del desarrollo de Erickson ocurre entre los 3 y 5 años?	Iniciativa	DesarrolloEmocional	Erickson
¿Cuál es la última etapa del desarrollo psicosocial?	Integridad	DesarrolloEmocional	Erickson
¿A qué edad se da la etapa de la autonomía?	1-3 años	DesarrolloEmocional	Erickson
¿Que busca la generatividad?	Busca trabajo creativo y productivo para la sociedad	DesarrolloEmocional	Erickson
¿En qué puntos se origina la identidad?	Se origina en la elección de una ocupación, la adopción de un valor por el cual vivir y el desarrollo de una identidad sexual satisfactoria	DesarrolloEmocional	Erickson
¿Que surge al superar la inferioridad y la laboriosidad?	Competencia	DesarrolloEmocional	Erickson
¿A qué edad surge la identidad en el desarrollo psicosocial	12-19 (adolescencia)	DesarrolloEmocional	Erickson
¿Que surge al superar el dilema entre la autonomía y de la vergüenza?	Voluntad	DesarrolloEmocional	Erickson
¿De dónde surge el propósito?	De superar la crisis entre la iniciativa y el remordimiento	DesarrolloEmocional	Erickson
¿Qué etapa le sigue al desarrollo de una identidad?	Intimidad	DesarrolloEmocional	Erickson
¿Que surge al superar la desconfianza?	Esperanza	DesarrolloEmocional	Erickson
¿Como se supera el estancamiento?	Se debe de preocupar más por lo que puede enseñar y aportar a los demás, en vez de lo que pueden hacer por la persona	DesarrolloEmocional	Erickson
¿Qué etapa del desarrollo psicosocial ocurre entre los 20 y 35 años?	Intimidad	DesarrolloEmocional	Erickson
¿Qué etapa se da entre los 35 y 64 en la teoría del desarrollo psicosocial?	Generatividad	DesarrolloEmocional	Erickson
¿Principal característica del estilo permisivo	Falta de control sobre los hijos (pero con mucho cariño)	DesarrolloEmocional	EstilosCrianza
¿Estilo en el cual los progenitores se les puede clasificar como negligentes?	Indiferente	DesarrolloEmocional	EstilosCrianza
¿Cuáles son los estilos de crianza?	Autoritativo, autoritario, permisivo e indiferente	DesarrolloEmocional	EstilosCrianza
¿Como son los hijos que crecen bajo un estilo autoritario?	Rebeldes, temerosos, mal humorados, tímidos, pasivos, rebeldes, agresivos	DesarrolloEmocional	EstilosCrianza
¿Estilo de crianza caracterizado por un gran control sobre los hijos?	Autoritario	DesarrolloEmocional	EstilosCrianza
¿Estilo en el que los niños no respetan limites, son agresivos, socialmente ineptos y autocomplacientes?	Permisivo	DesarrolloEmocional	EstilosCrianza
¿Como son las personas que crecen bajo un estilo autoritativo?	Mejor adaptadas a la sociedad, más seguros, más autocontrol, mejor rendimiento escolar	DesarrolloEmocional	EstilosCrianza
¿Características del estilo autoritativo?	Control moderado, reglas flexibles, comunicación abierta	DesarrolloEmocional	EstilosCrianza
¿Qué es el habla telegráfica?	Frases con dos palabras	DesarrolloEmocional	EtapasLenguaje
¿Qué es el lenguaje protodeclarativo?	Señalar cosas para que el adulto las vea	DesarrolloEmocional	EtapasLenguaje
¿Qué es el lenguaje protoimperativo?	Pedir cosas con el cuerpo	DesarrolloEmocional	EtapasLenguaje
¿En cuál periodo del desarrollo del lenguaje se tiene una capacidad similar a la de un adulto?	Desarrollo del lenguaje avanzado	DesarrolloEmocional	EtapasLenguaje
¿Etapa del desarrollo del lenguaje donde hay balbuceo sin significado?	Periodo Preverbal	DesarrolloEmocional	EtapasLenguaje
¿En cuál periodo del desarrollo del lenguaje surge la sobreextensión?	Periodo Holofrásico	DesarrolloEmocional	EtapasLenguaje
¿En cuál periodo del desarrollo del lenguaje están las palabras pivote?	Primeras combinaciones de palabras	DesarrolloEmocional	EtapasLenguaje
¿Cuál parte de la segunda tópica de Freud reprime impulsos?	Superyó	DesarrolloEmocional	Freud
¿En cuál nivel de la consciencia se almacenan sentimientos, deseos, vivencias que se encuentran reprimidos?	Inconsciente	DesarrolloEmocional	Freud
¿Nivel de la conciencia donde aplica el principio de la realidad?	Consciente e inconsciente	DesarrolloEmocional	Freud
¿En la segunda tópica de Freud, cual es la parte primitiva del individuo?	Ello o ID	DesarrolloEmocional	Freud
¿Cuál parte de la segunda tópica de Freud da la identidad a un individuo?	Yo	DesarrolloEmocional	Freud
¿Cuántas etapas hay en el desarrollo psicosexual de Freud?	Cinco: oral, anal, fálica, latencia y genital	DesarrolloEmocional	Freud
¿Nivel de la conciencia que es atemporal?	Inconsciente	DesarrolloEmocional	Freud
¿Que intenta explicar la teoría del desarrollo psicosexual?	Intenta explicar el desarrollo de la personalidad de un individuo.	DesarrolloEmocional	Freud
¿Acorde a Freud, que le da la moral a un individuo?	Superyó	DesarrolloEmocional	Freud
¿Cuál parte de la segunda tópica de Freud hace la toma de decisiones?	Yo	DesarrolloEmocional	Freud
¿Objetivo del Ello?	Satisfacer sus necesidades primitivas de supervivencia	DesarrolloEmocional	Freud
¿Definición de la pulsión	Una pulsión es un impulso psíquico cuya fuente es una excitación interna dirigida a un fin para calmar o suprimir un estado de tensión. Es un impulso que genera una excitación corporal y moviliza al organismo para suprimir dicho estado de tensión	DesarrolloEmocional	Freud
¿Nivel de la conciencia de más difícil acceso	Inconsciente.	DesarrolloEmocional	Freud
¿Que representa el Superyó?	Un ideal del yo	DesarrolloEmocional	Freud
¿Parte de la personalidad que ejecuta acciones y se autorregula?	Yo	DesarrolloEmocional	Freud
¿Nivel de la conciencia donde se encuentran elementos no presentes en la conciencia pero pueden aparecer fácilmente?	Preconsciente	DesarrolloEmocional	Freud
¿Cuáles elementos se encuentran en la segunda tópica de Freud?	Ello/ID, Yo/Ego, Superyó/Superego	DesarrolloEmocional	Freud
¿Cuál nivel de la conciencia se relaciona directamente con la realidad?	Consciente	DesarrolloEmocional	Freud
¿Cuáles elementos son incluidos por la primera tópica freudiana?	Consciente, preconsciente y el inconsciente.	DesarrolloEmocional	Freud
¿Qué es la mentalización?	Capacidad de pensar lo que otros individuos piensan	DesarrolloEmocional	FuncionesCognitivasSuperiores
¿Qué es la fluencia cognitiva?	Selección de esquemas pertinentes para acciones específicas	DesarrolloEmocional	FuncionesCognitivasSuperiores
¿Que hace la inhibición como Función ejecutiva?	Suprime información no relevante	DesarrolloEmocional	FuncionesCognitivasSuperiores
¿Menciona Funciones ejecutivas (6)	Memoria de trabajo, flexibilidad cognitiva, inhibición, planificación, toma de decisiones, actualización.	DesarrolloEmocional	FuncionesCognitivasSuperiores
¿Ejemplos de Funciones cognitivas superiores	Atención, lenguaje, memoria, aprendizaje, gnosias (reconocimiento complejo de objetos, formas y sonidos), praxia (uso de herramientas por movimientos coordinados), habilidades visoespaciales, Funciones ejecutivas	DesarrolloEmocional	FuncionesCognitivasSuperiores
¿Cuál es el proceso mental de mayor jerarquía?	Metacognición	DesarrolloEmocional	FuncionesCognitivasSuperiores
¿Usos de la metacognición?	Reflexión profunda, monitorizar y regular otros procesos	DesarrolloEmocional	FuncionesCognitivasSuperiores
¿Estructura cerebral que nos separa de los animales?	Corteza Cerebral	DesarrolloEmocional	Neuroanatomía
¿Dónde se regula la homeostasis del cuerpo?	En el tálamo	DesarrolloEmocional	Neuroanatomía
¿Cuáles emociones procesa principalmente la amígdala?	Miedo, ira y traumas	DesarrolloEmocional	Neuroanatomía
¿Estructura que administra y distribuye la información sensorial	Tálamo	DesarrolloEmocional	Neuroanatomía
¿Objetivo del neurodesarrollo	Maduración del SN, desarrollo de Funciones cerebrales y formación de la personalidad.	DesarrolloEmocional	Neuroanatomía
¿Sistema que controla emociones y la memoria?	Sistema límbico	DesarrolloEmocional	Neuroanatomía
¿Función del sistema límbico?	Dirigir emociones y al comportamiento. Formación de memoria largo plazo	DesarrolloEmocional	Neuroanatomía
¿Dónde se almacena el material genético de una neurona?	El material genético se almacena en el cuerpo/soma	DesarrolloEmocional	Neuroanatomía
¿A que estructuras precede el tubo neural?	A la medula espinal y al cerebro	DesarrolloEmocional	Neuroanatomía
¿En qué Áreas se da el desarrollo emocional y conductual?	Emocional, cognitiva y social.	DesarrolloEmocional	Neuroanatomía
¿Funciones del tálamo	Administrar impulsos cerebrales, conciencia, adquisición de conocimientos, cognición, emociones, memoria, movimiento voluntario.	DesarrolloEmocional	Neuroanatomía
¿Cuál es la unidad Funcional del SN?	Neurona	DesarrolloEmocional	Neuroanatomía
¿Estructuras que forman al sistema límbico?	Tálamo, hipotálamo, amígdala/hipófisis y el hipocampo	DesarrolloEmocional	Neuroanatomía
¿Cuáles son las estructuras de soporte del cerebro?	Meninges, cráneo y columna vertebral	DesarrolloEmocional	Neuroanatomía
¿Estructura cerebral que regula al SNA	Tálamo	DesarrolloEmocional	Neuroanatomía
¿De afuera hacia adentro, cuáles son las meninges?	Duramadre, aracnoides y piamadre	DesarrolloEmocional	Neuroanatomía
¿En qué estructuras se divide el encéfalo?	Prosencéfalo, Mesencéfalo y rombencéfalo	DesarrolloEmocional	Neuroanatomía
¿Cuáles son las células de la glía?	Oligodendrocitos/Células de Schwann, células epidemiarias, Microglía y astrocitos	DesarrolloEmocional	Neuroglia
¿En qué parte del sistema nervioso se encuentran las Células de Schwann?	En el Sistema Nervioso Periférico	DesarrolloEmocional	Neuroglia
¿Cuál es la Función de las células de la glía?	Darles apoyo a las neuronas	DesarrolloEmocional	Neuroglia
¿Qué tipo de estimulante es la dopamina?	Estimulante	DesarrolloEmocional	Neurotransmisores
¿Neurotransmisor estimulante de las Funciones autónomas, del aprendizaje y de la memoria?	Acetilcolina	DesarrolloEmocional	Neurotransmisores
¿Qué tipo de neurotransmisor es la noradrenalina?	Estimulante	DesarrolloEmocional	Neurotransmisores
¿Neurotransmisor que afecta la motivación y las sensaciones de recompensa?	Dopamina	DesarrolloEmocional	Neurotransmisores
¿Qué tipo de neurotransmisor es la acetilcolina?	Estimulante	DesarrolloEmocional	Neurotransmisores
¿Neurotransmisor que se relaciona con la excitación, la vigilia y el humor?	Noradrenalina	DesarrolloEmocional	Neurotransmisores
¿Qué tipo de neurotransmisor es el glutamato?	Estimulante (más importante)	DesarrolloEmocional	Neurotransmisores
¿Cuál es el inhibidor más importante?	GABA	DesarrolloEmocional	Neurotransmisores
¿Neurotransmisor estimulante relacionado con el aprendizaje y la memoria?	Glutamato	DesarrolloEmocional	Neurotransmisores
¿En cuál etapa del desarrollo cognitivo surge la moral?	En la etapa de operaciones formales	DesarrolloEmocional	Piaget
¿En cuál subestadio del desarrollo cognitivo busca objetos parcialmente escondidos?	Tercer subestadio	DesarrolloEmocional	Piaget
¿Subestadio del desarrollo cognitivo que se da entre los 12 hasta los 18 meses?	Quinto subestadio?	DesarrolloEmocional	Piaget
¿Entre que edades se da el sexto subestadio de desarrollo cognitivo?	18-24 meses.	DesarrolloEmocional	Piaget
¿Cuánto tiempo dura el primer subestadio del desarrollo cognitivo?	Un mes	DesarrolloEmocional	Piaget
¿Como se da una reacción circular primaria?	Cuando un lactante intenta repetir experiencias que se produjeron por casualidad	DesarrolloEmocional	Piaget
¿Definición de adaptación según Piaget:	Forma de procesar información nueva y acomodarla en el conocimiento que ya se tiene	DesarrolloEmocional	Piaget
¿En cuál subestadio del desarrollo cognitivo se forman los primeros hábitos?	Segundo subestadio (1-4m)	DesarrolloEmocional	Piaget
¿Cuál subestadio del desarrollo cognitivo se da entre los 4-8 meses?	Tercer subestadio	DesarrolloEmocional	Piaget
¿En cuál subestadio se dan las reacciones circulares primarias?	Segundo subestadio	DesarrolloEmocional	Piaget
¿Fases del desarrollo cognitivo de Piaget?	Sensomotora, preoperacional, operaciones concretas, operaciones formales	DesarrolloEmocional	Piaget
¿Etapa del desarrollo cognitivo donde se puede usar la lógica pero no comprender hipótesis	Operaciones concretas	DesarrolloEmocional	Piaget
¿Etapa del desarrollo cognitivo donde se aprende principalmente por medio de la imitación?	Etapa preoperacional	DesarrolloEmocional	Piaget
¿Como aprende un niño en la etapa sensomotora?	Aprende por medio de actividades sensomotoras	DesarrolloEmocional	Piaget
¿Etapa del desarrollo cognitivo de Piaget que ocurre antes de los dos años	Sensomotora	DesarrolloEmocional	Piaget
¿En cuál subestadio coordina esquemas secundarios y aplica medios conocidos a situaciones nuevas?	Cuarto subestadio (8-12)	DesarrolloEmocional	Piaget
¿Cuáles son las reacciones circulares terciarias?	Experimentar con diferentes acciones para dar diferentes resultados	DesarrolloEmocional	Piaget
¿Etapa del desarrollo cognitivo donde se empieza a desarrollar la lógica?	Operaciones concretas	DesarrolloEmocional	Piaget
¿Etapa del desarrollo cognitivo donde se empieza usar el lenguaje de forma limitada	Preoperacional	DesarrolloEmocional	Piaget
¿Entre que edades se da el cuarto subestadio del desarrollo cognitivo?	8 a 12 meses	DesarrolloEmocional	Piaget
¿Que surge en el tercer subestadio del desarrollo cognitivo?	Coordinación visión prensión y reacciones circulares secundarias	DesarrolloEmocional	Piaget
¿Qué es el aprendizaje latente?	Adquisición de conocimientos no observables inmediatamente en el comportamiento	DesarrolloEmocional	Piaget
¿Que se presenta en el primer subestadio del desarrollo cognitivo?	Reflejos y movimientos espontáneos	DesarrolloEmocional	Piaget
¿En cuál subestadio de desarrollo cognitivo se dan las reacciones circulares terciarias?	Quinto subestadio	DesarrolloEmocional	Piaget
¿Qué es la cognición acorde a Piaget?	Proceso interrelacionado para obtener y usar conocimiento	DesarrolloEmocional	Piaget
¿Como define Piaget a la inteligencia?	Forma compleja de adaptación por parte de un organismo complejo en un entorno complejo	DesarrolloEmocional	Piaget
¿Después de que edad se considera que ocurre la etapa de operaciones formales?	Después de los once años (secundaria)	DesarrolloEmocional	Piaget
¿Cuantos meses dura el segundo subestadio?	3 (1-4)	DesarrolloEmocional	Piaget
¿Fase del desarrollo cognitivo en el que suele iniciar la escolarización	Preoperacional (2-7 años)	DesarrolloEmocional	Piaget
¿Componentes de la inteligencia según Piaget	Organización de esquemas cerebrales, adaptación, equilibrio entre pensamientos	DesarrolloEmocional	Piaget
¿En cuál subestadio de desarrollo cognitivo combina dos esquemas para obtener resultados?	Cuarto subestadio	DesarrolloEmocional	Piaget
¿Factores del desarrollo cognitivo de Piaget?	Maduración orgánica, interacción con el medio físico, interacción con el medio social, equilibración	DesarrolloEmocional	Piaget
¿Como suceden las reacciones circulares secundarias?	Cuando descubre algo interesante fuera de su cuerpo y lo repite	DesarrolloEmocional	Piaget
¿Años en los que se da la etapa de operaciones concretas?	7-11 (primaria)	DesarrolloEmocional	Piaget
¿En cuál subestadio comienza el pensamiento como tal?	Sexto subestadio	DesarrolloEmocional	Piaget
¿Procesos mentales que se pueden llevar a cabo en la etapa de operaciones concretas?	Clarificar, reversibilidad, conservación, descentramiento y transmisibilidad.	DesarrolloEmocional	Piaget
¿Etapa del desarrollo cognitivo donde predominan las actitudes reflejo	Etapa sensomotora	DesarrolloEmocional	Piaget
¿En cuál etapa del desarrollo cognitivo un niño puede usar la lógica, razonamiento deductivo y comprender ideas abstractas?	Operaciones formales	DesarrolloEmocional	Piaget
¿Tipos de neurotransmisores?	Excitatorios e inhibitorios	DesarrolloEmocional	Plasticidad
¿Qué es la metilación?	Mecanismo en el cual se añaden grupos metilo al ADN para apagar genes	DesarrolloEmocional	Plasticidad
¿Cuál es la plasticidad que toma más tiempo en desarrollarse?	Plasticidad estructural?	DesarrolloEmocional	Plasticidad
¿Cuál tipo de plasticidad cerebral refleja el aprendizaje de una persona?	Plasticidad Estructural	DesarrolloEmocional	Plasticidad
¿Ejemplos de neurotransmisores?	Serotonina, dopamina, acetilcolina, GABA, adrenalina, endorfinas	DesarrolloEmocional	Plasticidad
¿A qué se relaciona la plasticidad estructural?	Memoria a largo plazo y habilidades motoras	DesarrolloEmocional	Plasticidad
¿Tipo de unión que comunica eléctricamente a dos neuronas?	Uniones de hendidura	DesarrolloEmocional	Sinapsis
¿Tipos de plasticidad cerebral?	Sináptica y estructural	DesarrolloEmocional	Sinapsis
¿A qué edad ocurre la poda neural?	2-4 años	DesarrolloEmocional	Sinapsis
¿Estructura que separa las neuronas en la sinapsis química?	Hendidura sináptica	DesarrolloEmocional	Sinapsis
¿En cuales tipos de tejido son más comunes las comunicaciones por hendidura?	Musculo cardiaco, embriones y en el encéfalo	DesarrolloEmocional	Sinapsis
¿Tipo de sinapsis donde las neuronas no se tocan?	Sinapsis química	DesarrolloEmocional	Sinapsis
¿Cuáles son los tres tipos de sinapsis?	Axoaxónicas, axodendríticas y axosomáticas	DesarrolloEmocional	Sinapsis
¿Qué tipo de plasticidad cerebral se asocia a la memoria de corto plazo?	Sináptica	DesarrolloEmocional	Sinapsis
¿Cuáles tipos de comunicación puede hacer una neurona?	Química y eléctrica	DesarrolloEmocional	Sinapsis
¿En cuál etapa del desarrollo de Spitz se empieza a dividir el aparato psíquico?	Precursor del objeto	DesarrolloEmocional	Spitz
¿En cuál etapa del desarrollo de Spitz él bebe empieza a buscar autonomía?	En la del objeto real	DesarrolloEmocional	Spitz
¿En cuál etapa del desarrollo de Spitz se empieza a poner límites?	En la etapa del objeto libidinal	DesarrolloEmocional	Spitz
¿Acorde a Spitz, cual es el primer concepto que un bebé aprende?	Él no es el primer concepto que aprende	DesarrolloEmocional	Spitz
¿En cuál periodo de edad se encuentra la etapa precursora al objeto?	tres a ocho meses	DesarrolloEmocional	Spitz
¿En cuál etapa surge el segundo organizador mental de la teoría de Spitz?	Tercera etapa: objeto libidinal o real	DesarrolloEmocional	Spitz
¿Tipo de aislamiento de apego que tiene consecuencias mayormente reversibles?	Depresión analítica.	DesarrolloEmocional	Spitz
¿En cuál etapa del desarrollo de Spitz lo más importante es la relación entre la mamá y él bebe?	Primera infancia/preobjetal	DesarrolloEmocional	Spitz
¿Cuánto tiempo de separación debe pasar para que se considere hospitalismo?	Mas de cinco meses	DesarrolloEmocional	Spitz
¿Cuál es el primer organizador mental en la teoría de Spitz y en que etapa surge?	El primer organizador es la sonrisa y surge al final de la preobjetal	DesarrolloEmocional	Spitz
¿Cuáles son los organizadores mentales de la Teoría de Spitz?	La sonrisa, la angustia de separación o del octavo mes y la palabra no	DesarrolloEmocional	Spitz
¿En cuál etapa del desarrollo de Spitz él bebe considera al mundo como extensión de sí mismo?	Primera infancia o preobjetal	DesarrolloEmocional	Spitz
¿En cuál etapa del desarrollo de Spitz él bebe reconoce sonrisas pero no rostros?	Precursor del objeto	DesarrolloEmocional	Spitz
¿En cuál etapa del desarrollo de Spitz él bebe puede reconocer a su mamá?	En la etapa del objeto real	DesarrolloEmocional	Spitz
¿Tipo de separación del cuidador que genera daños psicosomáticos irreversibles?	Hospitalismo	DesarrolloEmocional	Spitz
¿Acorde a Vygotsky, que es el andamiaje?	Aprendizaje guiado por otras personas	DesarrolloEmocional	Vygotsky
¿Tipo del lenguaje usado para regular el pensamiento y la conducta?	Habla egocéntrica	DesarrolloEmocional	Vygotsky
¿Como se llama al nivel del desarrollo cognoscitivo que incluye lo que un niño puede resolver con ayuda de un adulto?	Desarrollo potencial	DesarrolloEmocional	Vygotsky
¿Como se llama la teoría de Vygotsky?	Socioconstructivismo	DesarrolloEmocional	Vygotsky
¿Qué es el desarrollo cognoscitivo real?	Lo que un niño puede hacer y resolver por su cuenta	DesarrolloEmocional	Vygotsky
¿Tipos del lenguaje acorde a Vygotsky?	Social, habla egocéntrica, habla interna	DesarrolloEmocional	Vygotsky
¿Acorde a Vygotsky, ¿cómo se da el aprendizaje?	Por interacción social	DesarrolloEmocional	Vygotsky
¿Función de las Funciones ejecutivas	Guiar la conducta dirigida a logros y a la resolución de problemas	DesarrolloEmocional	Vygotsky
¿Qué es el lenguaje?	Medio que permite expresar ideas, generar categorías, vínculos temporales y es el principal medio de comunicación	DesarrolloEmocional	Vygotsky
¿Qué hace el habla interna?	El pensamiento y el habla dirigen la conducta. Se puede reflexionar y planear por medio de Funciones ejecutivas.	DesarrolloEmocional	Vygotsky
¿Acorde a Vygotsky, cuáles son los dos niveles del del desarrollo cognoscitivo?	Desarrollo real y potencial	DesarrolloEmocional	Vygotsky
¿Tipo de moldeamiento usado para modificar pensamientos y la conducta	Lenguaje psicológico	DesarrolloEmocional	Vygotsky
¿Qué es lenguaje social?	Tipo de lenguaje usado para comunicarse, pero que no necesariamente moldea al pensamiento	DesarrolloEmocional	Vygotsky
¿Deletrea Vygotsky	V y g o t s k y	DesarrolloEmocional	Vygotsky
¿Acorde a Vygotsky, como interpretamos al mundo?	Lo hacemos por medio del aprendizaje de significados compartidos	DesarrolloEmocional	Vygotsky
¿Para qué es el moldeamiento técnico?	Se usa para modificar objetos y al ambiente	DesarrolloEmocional	Vygotsky
¿Como se llama al Área del desarrollo entre el potencial y el real?	Zona de desarrollo proximal	DesarrolloEmocional	Vygotsky
¿Para Vygotsky, cuáles son los elementos del lenguaje?	Contenido/significado, forma (como se manda), uso(oyente/locutor)	DesarrolloEmocional	Vygotsky
¿Acorde a Vygotsky, que es la autonomía?	Habilidad para aprender y extrapolar conocimientos por sí solo	DesarrolloEmocional	Vygotsky
